[
  {
    "type": "mapgen",
    "method": "json",
    "om_terrain": [ [ "urban_7_1", "urban_7_2" ] ],
    "object": {
      "fill_ter": "t_floor",
      "rows": [
        "%%%%%%%%%%%```%%%%%%%%%%%%%%%%%%%%%%%%%%%%%%%%%%",
        "%..........```.................................%",
        "%.........p`````````````````````````````````...%",
        "%..........```............%%%%%...%%%%%....`...%",
        "%.........`````..........##ooo#####ooo##.%%`...%",
        "%......%%```````%%......%#y   yxxx  s y#.%%`%%.%",
        "%......%%```````%%......%o          E  o...`%%.%",
        "%....```````````````....%o   E lll     o.%%`...%",
        "%...````````````````....%o     HHH    M#.%%`%%.%",
        "%...````...%%%...````...%#L  |||||||  |#...`%%.%",
        "%...```...%%%%%...```````*    <|t¨|R  R#.%%`...%",
        "%...```...%%%%%...```````*    <|S¨|R  R#.%%`%%.%",
        "%...````...%%%...````...%#   ||||+||  |#...`%%.%",
        "%...````````````````....%oy   hhh      #.%%`...%",
        "%....```````````````....%oc   fff     ro.%%`%%.%",
        "%.......`````````.......%oy   hhh    hro...`%%.%",
        "%.........``........%%%%%#            yo...`...%",
        "%....%%%..``..^########### ˙˙˙˙˙˙˙˙ RRT#...`...%",
        "%....%[%..``..%#q'q'6|yy   ˙˙˙AAA˙˙||||#...`...%",
        "%....%%%..``..%#q'q'6|     ˙˙˙JJJ˙˙|QQg#``%`...%",
        "%.........`````*'''''+     ˙˙˙˙˙˙˙˙+   *````...%",
        "%.............%#UUUUU|Y    45n3O21F|ZWĴ#``%..u.%",
        "%.............%#########################.......%",
        "%%%%%%%%%%%%%%%%%%%%%%%%%%%%%%%%%%%%%%%%%%%%%%%%"
      ],
      "palettes": [
        "standard_domestic_palette",
        "parameterized_linoleum_color_kitchen",
        "parameterized_linoleum_color_bathroom",
        "standard_domestic_landscaping_palette"
      ],
      "terrain": {
        "'": "t_thconc_floor",
        "q": "t_thconc_floor",
        "U": "t_thconc_floor",
        "6": "t_thconc_floor",
        "A": { "param": "linoleum_color_kitchen", "fallback": "t_linoleum_white" },
        "Q": "t_floor"
      },
      "furniture": { "Ĵ": "f_counter" },
      "place_loot": [ { "item": "stereo", "x": 32, "y": 5, "chance": 65 }, { "item": "television", "x": 32, "y": 5, "chance": 100 } ]
    }
  },
  {
    "type": "mapgen",
    "method": "json",
    "om_terrain": [ [ "urban_7_3", "urban_7_4" ] ],
    "object": {
      "fill_ter": "t_floor",
      "rows": [
        "~~~~~~~~~~~~~~~~~~~~~~~~~~~~~~~~~~~~~~~~~~~~~~~~",
        "~~~~~~~~~~~~~~~~~~~~~~~~~~~~~~~~~~~~~~~~~~~~~~~~",
        "~~~~~~~~~~~~~~~~~~~~~~~~~~~~~~~~~~~~~~~~~~~~~~~~",
        "~~~~~~~~~~~~~~~~~~~~~~~~~~~~~~~~~~~~~~~~~~~~~~~~",
        "~~~~~~~~~~~~~~~~~~~~~~~~~###############~~~~~~~~",
        "~~~~~~~~~~~~~~~~~~~~~~~~~#RR  ¤@@@¤  ET#~~~~~~~~",
        "~~~~~~~~~~~~~~~~~~~~~~~~~o     @@@     o~~~~~~~~",
        "~~~~~~~~~~~~~~~~~~~~~~~~~o     @@@     o~~~~~~~~",
        "~~~~~~~~~~~~~~~~~~~~~~~~~#y          dd#~~~~~~~~",
        "~~~~~~~~~~~~~~~~~~~~~~~~~#|+||||+|||+||#~~~~~~~~",
        "~~~~~~~~~~~~~~~~~~~~~~~~~#B¨t|>  |D   D#~~~~~~~~",
        "~~~~~~~~~~~~~~~~~~~~~~~~~#B¨S|>  ||||||#~~~~~~~~",
        "~~~~~~~~~~~~~~~~~~~~~~~~~#|||||| |¨¨t¨B#~~~~~~~~",
        "~~~~~~~~~~~~~~~~~~~~~~~~~#y III| +¨¨¨¨B#~~~~~~~~",
        "~~~~~~~~~~~~~~~~~~~~~~~~~o   hI| |8S8¨¨#~~~~~~~~",
        "~~~~~~~~~~~~~~~~~~~~~~~~~o     + ||||||#~~~~~~~~",
        "~~~~~~~~~~~~~~~~~~~~~~~~~#  @  | |RR hIo~~~~~~~~",
        "~~~~~~~~~~~~~~~##:::::::##T @ d| |    I#~~~~~~~~",
        "~~~~~~~~~~~~~~^# EsE     ||||||| +    @#~~~~~~~~",
        "~~~~~~~~~~~~~~~:         +       |    @#~~~~~~~~",
        "~~~~~~~~~~~~~~~:E        ||||+||||d    #~~~~~~~~",
        "~~~~~~~~~~~~~~~#sE   EsE +g|U w|D+  y  o~~~~~~~~",
        "~~~~~~~~~~~~~~~##:::::::###########o#o##~~~~~~~~",
        "~~~~~~~~~~~~~~~~~~~~~~~~~~~~~~~~~~~~~~~~~~~~~~~~"
      ],
      "palettes": [ "standard_domestic_palette", "parameterized_linoleum_color_bathroom" ],
      "terrain": { "~": "t_open_air", "w": "t_floor" }
    }
  },
  {
    "type": "mapgen",
    "method": "json",
    "om_terrain": [ [ "urban_7_5", "urban_7_6" ] ],
    "object": {
      "fill_ter": "t_shingle_flat_roof",
      "rows": [
        "                                                ",
        "                                                ",
        "                                                ",
        "                                                ",
        "                         ---------------        ",
        "                         -.............-        ",
        "                         -.............-        ",
        "                         -..........N..-        ",
        "                         -.............-        ",
        "                         -....=........-        ",
        "                         -.............-        ",
        "                         -.............-        ",
        "                         -.......=.....-        ",
        "                         -.............-        ",
        "                         -.............-        ",
        "                         -.............-        ",
        "                         -.............-        ",
        "               5----------.............-        ",
        "               -.......................-        ",
        "               -.......................-        ",
        "               -.......................-        ",
        "               -.......................-        ",
        "               -------------------------        ",
        "                                                "
      ],
      "palettes": [ "roof_palette" ],
      "terrain": { ".": "t_shingle_flat_roof" },
      "place_nested": [ { "chunks": [ "NC_res_roof_solar_4X4" ], "x": 27, "y": 15 } ]
    }
  }
]
