[
  {
    "type": "mapgen",
    "method": "json",
    "om_terrain": "house_w_3",
    "object": {
      "fill_ter": "t_floor",
      "rows": [
        "........p``.............",
        ".........``.............",
        "......µ``````µ..........",
        ".....%````````%.........",
        "..!!!%````````%!!!......",
        "##o#o###o**o###ooo##....",
        "#α    |      |ε   y#`...",
        "#     |δ     |  ζ  *`...",
        "#     |      +     #```.",
        "o     |      |Y    #!!`.",
        "#     +      ||||||###`.",
        "#||+|||      +  9|v|U*`.",
        "#D|D|>+      |Swt| |g#..",
        "#+|||||γ     |||||+###..",
        "#β    +      |667Y #^...",
        "o     |            o....",
        "#     |      |    1#....",
        "#     |      |    O#....",
        "#     |      |F5342#....",
        "####o###o##o###o####....",
        "........................",
        "........................",
        "........................",
        "........................"
      ],
      "palettes": [ "standard_domestic_palette", "standard_domestic_landscaping_palette" ],
      "terrain": { "#": "t_rock_wall", "µ": "t_column" },
      "nested": {
        "α": {
          "chunks": [
            [ "bedroom_5x5_adult_N_1", 50 ],
            [ "bedroom_5x5_adult_N_2", 50 ],
            [ "bedroom_5x5_adult_E_2", 50 ],
            [ "bedroom_5x5_adult_W_2", 50 ]
          ]
        },
        "β": {
          "chunks": [
            [ "bedroom_5x5_adult_S_1", 50 ],
            [ "bedroom_5x5_adult_E_1", 50 ],
            [ "bedroom_5x5_adult_W_1", 50 ],
            [ "bedroom_5x5_adult_S_2", 50 ],
            [ "bedroom_5x5_adult_E_2", 50 ],
            [ "bedroom_5x5_adult_W_2", 50 ]
          ]
        },
        "γ": {
          "chunks": [
            [ "diningroom_6x6_N_S_1A", 20 ],
            [ "diningroom_6x6_E_W_1", 20 ],
            [ "diningroom_6x6_E_W_2", 20 ],
            [ "diningroom_6x6_N_S_2", 20 ]
          ]
        },
        "δ": { "chunks": [ [ "livingroom_5x5_N_1", 20 ], [ "livingroom_5x5_S_1", 20 ] ] },
        "ε": {
          "chunks": [
            [ "bonus_room_2x2_1", 50 ],
            [ "bonus_room_2x2_2", 50 ],
            [ "bonus_room_2x2_4_W", 50 ],
            [ "bonus_room_2x2_4_N", 50 ],
            [ "bonus_room_3x3_1", 50 ],
            [ "bonus_room_3x3_2", 50 ]
          ]
        },
        "ζ": {
          "chunks": [
            [ "bonus_room_3x3_4", 50 ],
            [ "bonus_room_3x3_W_6", 50 ],
            [ "bonus_room_3x3_S_6", 50 ],
            [ "bonus_room_3x3_W_8", 50 ],
            [ "bonus_room_3x3_S_8", 50 ]
          ]
        }
      },
      "place_nested": [
        {
          "chunks": [ [ "null", 30 ], [ "garden_3x3_1", 20 ], [ "garden_3x3_2", 20 ], [ "garden_3x3_3", 20 ] ],
          "x": 2,
          "y": 21
        },
        {
          "chunks": [ [ "null", 30 ], [ "garden_3x3_1", 20 ], [ "garden_3x3_2", 20 ], [ "garden_3x3_3", 20 ] ],
          "x": 6,
          "y": 21
        },
        {
          "chunks": [ [ "null", 30 ], [ "garden_3x3_1", 20 ], [ "garden_3x3_2", 20 ], [ "garden_3x3_3", 20 ] ],
          "x": 10,
          "y": 21
        },
        {
          "chunks": [ [ "null", 30 ], [ "garden_3x3_1", 20 ], [ "garden_3x3_2", 20 ], [ "garden_3x3_3", 20 ] ],
          "x": 14,
          "y": 21
        }
      ]
    }
  },
  {
    "type": "mapgen",
    "method": "json",
    "om_terrain": "house_w_3_roof",
    "object": {
      "fill_ter": "t_shingle_flat_roof",
      "rows": [
        "                        ",
        "                        ",
        "      ........          ",
        "      ........          ",
        "      ........          ",
        "--------------------    ",
        "-..................-    ",
        "-..................-    ",
        "-..................-    ",
        "-..................-    ",
        "-..................---  ",
        "-....................-  ",
        "-....................-  ",
        "-..................5--  ",
        "-..................-    ",
        "-..................-    ",
        "-..................-    ",
        "-..................-    ",
        "-..................-    ",
        "--------------------    ",
        "                        ",
        "                        ",
        "                        ",
        "                        "
      ],
      "palettes": [ "roof_palette" ],
      "terrain": { ".": "t_shingle_flat_roof" }
    }
  },
  {
    "type": "mapgen",
    "method": "json",
    "om_terrain": "house_w_3_basement",
    "object": {
      "fill_ter": "t_thconc_floor",
      "rows": [
        "                        ",
        "                        ",
        "                        ",
        "                        ",
        "                        ",
        "||||||||||||||||||||    ",
        "|..................|    ",
        "|..................|    ",
        "|..................|    ",
        "|..................|    ",
        "|..................|||  ",
        "|JJ...........z..z..F|  ",
        "|W...<..............g|  ",
        "|J..A.....z..z.....|||  ",
        "|Z.................|    ",
        "|..................|    ",
        "|..................|    ",
        "|.......z.........z|    ",
        "|..................|    ",
        "||||||||||||||||||||    ",
        "                        ",
        "                        ",
        "                        ",
        "                        "
      ],
      "palettes": [ "basement_empty" ]
    }
  }
]
