[
  {
    "type": "mapgen",
    "method": "json",
    "om_terrain": "house_w_6",
    "object": {
      "fill_ter": "t_floor",
      "rows": [
        "..........p``...........",
        "...[..%%%%%``%%%%%......",
        "......µ''''''''''µ..[...",
        ".[..[.''''''''''''....[.",
        "....%%''''''''jjj'%%....",
        "....##oo##o**##ooo##....",
        "....#β  R|L  |γ    #....",
        "....#   R|s  |     #....",
        "....#    ||++|     #....",
        "....#Y       |     #....",
        "..%##|||||         #....",
        "..%o<              #....",
        "..%o>RRT y|+||||  |#....",
        "..%##||| ||St|α    #....",
        "...^#1O2 F||||     #....",
        "...%o5   Y|66|     o%...",
        "...%o3             o%...",
        "...%#4  y7|66|     #....",
        "....##*o#######o#o##....",
        ".....%`%................",
        ".....```................",
        ".....```................",
        "........................",
        "........................"
      ],
      "palettes": [ "standard_domestic_palette", "standard_domestic_landscaping_palette" ],
      "terrain": { "'": "t_thconc_floor", "i": "t_thconc_floor", "µ": "t_column" },
      "nested": {
        "α": { "chunks": [ [ "diningroom_5x5_N_S", 50 ], [ "diningroom_5x5_E_W", 50 ] ] },
        "β": {
          "chunks": [
            [ "bonus_room_3x3_2", 50 ],
            [ "bonus_room_3x3_3", 50 ],
            [ "bonus_room_3x3_4", 50 ],
            [ "bonus_room_3x3_5", 50 ],
            [ "bonus_room_3x3_N_6", 50 ],
            [ "bonus_room_3x3_W_6", 50 ]
          ]
        },
        "γ": {
          "chunks": [
            [ "livingroom_5x5_N_1", 50 ],
            [ "livingroom_5x5_S_1", 50 ],
            [ "livingroom_5x5_N_2", 50 ],
            [ "livingroom_5x5_S_2", 50 ],
            [ "livingroom_5x5_E_2", 50 ],
            [ "livingroom_5x5_W_2", 50 ]
          ]
        }
      },
      "place_nested": [
        {
          "chunks": [ [ "null", 50 ], [ "firepit_5x5_2", 15 ], [ "reflecting_pool_5x5_1", 15 ], [ "reflecting_pool_5x5_2", 25 ] ],
          "x": [ 9, 13 ],
          "y": 19
        }
      ]
    }
  },
  {
    "type": "mapgen",
    "method": "json",
    "om_terrain": "house_w_6_2ndfloor",
    "object": {
      "fill_ter": "t_floor",
      "rows": [
        "~~~~~~~~~~~~~~~~~~~~~~~~",
        "~~~~~~~~~~~~~~~~~~~~~~~~",
        "~~~~~~============~~~~~~",
        "~~~~~~============~~~~~~",
        "~~~~~~============~~~~~~",
        "~~~~##oo########oo##~~~~",
        "~~~~#α    +D| +β   #~~~~",
        "~~~~#    H|||D|    #~~~~",
        "~~~~#    L|w|||    #~~~~",
        "~~~~#     |+| +    #~~~~",
        "~~~##||||+|   |||||#~~~~",
        "~~~o>         +w|vD#~~~~",
        "~~~oRR|||+||| ||||+#~~~~",
        "~~~##||Ry +D| +    #~~~~",
        "~~~~#γ    |||+|δ   #~~~~",
        "~~~^#     |t  |    o~~~~",
        "~~~~o     |S B|    o~~~~",
        "~~~~#     |8 B|    #~~~~",
        "~~~~###o####o####o##~~~~",
        "~~~~~~~~~~~~~~~~~~~~~~~~",
        "~~~~~~~~~~~~~~~~~~~~~~~~",
        "~~~~~~~~~~~~~~~~~~~~~~~~",
        "~~~~~~~~~~~~~~~~~~~~~~~~",
        "~~~~~~~~~~~~~~~~~~~~~~~~"
      ],
      "palettes": [ "standard_domestic_palette" ],
      "terrain": { "~": "t_open_air", "=": "t_shingle_flat_roof" },
      "nested": {
        "α": {
          "chunks": [
            [ "bedroom_4x4_adult_1_N", 20 ],
            [ "bedroom_4x4_adult_1_S", 20 ],
            [ "bedroom_4x4_adult_2_N", 20 ],
            [ "bedroom_4x4_adult_3_S", 200 ],
            [ "bedroom_4x4_adult_3_N", 200 ]
          ]
        },
        "β": {
          "chunks": [
            [ "bedroom_4x4_adult_1_S", 20 ],
            [ "bedroom_4x4_adult_3_S", 200 ],
            [ "bedroom_4x4_adult_3_N", 200 ],
            [ "bedroom_4x4_adult_3_E", 200 ],
            [ "bedroom_4x4_adult_3_W", 200 ]
          ]
        },
        "γ": {
          "chunks": [
            [ "bedroom_4x4_adult_1_S", 20 ],
            [ "bedroom_4x4_adult_2_W", 20 ],
            [ "bedroom_4x4_adult_2_S", 20 ],
            [ "bedroom_4x4_adult_3_S", 200 ],
            [ "bedroom_4x4_adult_3_W", 200 ]
          ]
        },
        "δ": {
          "chunks": [
            [ "bedroom_4x4_adult_1_E", 20 ],
            [ "bedroom_4x4_adult_2_W", 20 ],
            [ "bedroom_4x4_adult_2_W", 20 ],
            [ "bedroom_4x4_adult_3_E", 200 ],
            [ "bedroom_4x4_adult_3_W", 200 ]
          ]
        }
      }
    }
  },
  {
    "type": "mapgen",
    "method": "json",
    "om_terrain": "house_w_6_roof",
    "object": {
      "fill_ter": "t_shingle_flat_roof",
      "rows": [
        "                        ",
        "                        ",
        "                        ",
        "                        ",
        "                        ",
        "    ----------------    ",
        "    -..............-    ",
        "    -..............-    ",
        "    -..............-    ",
        "    -..............-    ",
        "   --..............-    ",
        "   -...............-    ",
        "   -...............-    ",
        "   --..............-    ",
        "    -......&.......-    ",
        "    5..............-    ",
        "    -..............-    ",
        "    -..............-    ",
        "    ----------------    ",
        "                        ",
        "                        ",
        "                        ",
        "                        ",
        "                        "
      ],
      "palettes": [ "roof_palette" ],
      "terrain": { ".": "t_shingle_flat_roof" }
    }
  },
  {
    "type": "mapgen",
    "method": "json",
    "om_terrain": "house_w_6_basement",
    "object": {
      "fill_ter": "t_thconc_floor",
      "rows": [
        "                        ",
        "                        ",
        "                        ",
        "                        ",
        "                        ",
        "    ||||||||||||||||    ",
        "    |Z.1...........|    ",
        "    |J.............|    ",
        "    |J.............|    ",
        "    |W.............|    ",
        "   ||..............|    ",
        "   |U..............|    ",
        "   |<..............|    ",
        "   ||..............|    ",
        "    |..............|    ",
        "    |g.............|    ",
        "    |..............|    ",
        "    |F.............|    ",
        "    ||||||||||||||||    ",
        "                        ",
        "                        ",
        "                        ",
        "                        ",
        "                        "
      ],
      "palettes": [ "basement_empty" ],
      "nested": { "1": { "chunks": [ [ "null", 70 ], [ "recroom_12x12", 30 ], [ "tvroom_12x12", 30 ], [ "workoutroom_12x12", 30 ] ] } }
    }
  }
]
