[
  {
    "method": "json",
    "om_terrain": [ [ "urban_2_1", "urban_2_2" ] ],
    "type": "mapgen",
    "object": {
      "fill_ter": "t_floor",
      "rows": [
        "...p______!______...............................",
        "....______!______...........................[...",
        "....______.______............[..................",
        "....______!______`````..........................",
        "....______!______`````..........................",
        "....______.______...``....%%%%....%%%%..........",
        "..##======#======##````####oo######oo####.......",
        "..#&'''''''''''''&#````#TE             R#^......",
        "..#'''''''''''''''#o**o#E     hhhh     R#.......",
        "..o'''''''''''''''#L  y|     ffffff    a#.......",
        "..#N''''''''''''''#           hhhh     R#.......",
        "..#N''''''''''''''+    |y              R#.......",
        "..#'''''''''''''''#  |<|||||||||  ||||+|#.......",
        "..o'''''''''''''''#  |||8S8|RR      |6˙6#.......",
        "..#q''''''''''''''#  +Q|¨¨¨|        ||||#.......",
        "..#q'''''''''''''A#  +>|t¨||        |UUU#..[....",
        "..###oo####+#######˙˙||||+|   HHHH  |'''#.......",
        "..^......#q'q|JJJJY˙˙˙0|y   E      E##+##.......",
        ".........#||||J00˙˙˙˙˙˙˙    s  ll   o```........",
        ".........#6+˙˙˙˙˙˙˙˙˙˙n|    E       *`````......",
        "....[....#6|JJJF1O75432|L     xxxxT o`````......",
        ".........####o####ooo####*#o#########`````...u..",
        ".........................```````````````........",
        "................................................"
      ],
      "palettes": [
        "standard_domestic_palette",
        "parameterized_linoleum_color_kitchen",
        "parameterized_linoleum_color_bathroom",
        "standard_domestic_landscaping_palette"
      ],
      "terrain": {
        "&": "t_gates_mech_control",
        "=": "t_door_metal_locked",
        "'": "t_thconc_floor",
        "q": "t_thconc_floor",
        "A": "t_thconc_floor",
        "N": "t_thconc_floor",
        "U": "t_thconc_floor",
        "Y": { "param": "linoleum_color_kitchen", "fallback": "t_linoleum_white" },
        "0": { "param": "linoleum_color_kitchen", "fallback": "t_linoleum_white" },
        "Q": "t_floor"
      },
      "furniture": { "0": "f_stool" },
      "place_loot": [
        { "item": "television", "x": 32, "y": 20, "chance": 100 },
        { "item": "stereo", "x": 31, "y": 20, "chance": 100 },
        { "item": "lawnmower", "x": 39, "y": 16, "chance": 100 },
        { "item": "stepladder", "x": 37, "y": 16, "chance": 100 }
      ],
      "place_vehicles": [
        { "vehicle": "suburban_home", "x": 7, "y": 12, "chance": 30, "rotation": 90 },
        { "vehicle": "suburban_home", "x": 14, "y": 12, "chance": 30, "rotation": 90 }
      ]
    }
  },
  {
    "method": "json",
    "om_terrain": [ [ "urban_2_3", "urban_2_4" ] ],
    "type": "mapgen",
    "object": {
      "fill_ter": "t_floor",
      "rows": [
        "~~~~~~~~~~~~~~~~~~~~~~~~~~~~~~~~~~~~~~~~~~~~~~~~",
        "~~~~~~~~~~~~~~~~~~~~~~~~~~~~~~~~~~~~~~~~~~~~~~~~",
        "~~~~~~~~~~~~~~~~~~~~~~~~~~~~~~~~~~~~~~~~~~~~~~~~",
        "~~~~~~~~~~~~~~~~~~~~~~~~~~~~~~~~~~~~~~~~~~~~~~~~",
        "~~~~~~~~~~~~~~~~~~~~~~~~~~~~~~~~~~~~~~~~~~~~~~~~",
        "~~~~~~~~~~~~~~~~~~~~~~~~~~~~~~~~~~~~~~~~~~~~~~~~",
        "~~----------------###ooo########o#####o##~~~~~~~",
        "~~-===============#IIIT  R|Q|D|d II    T#~~~~~~~",
        "~~-===============oIh     + | +  h  E  R#^~~~~~~",
        "~~-===============#I    ER|v|D|@@   l  a#~~~~~~~",
        "~~-===============#|||+||||||||@@   E  R#~~~~~~~",
        "~~-===============#           +         #~~~~~~~",
        "~~-===============oy |>|||||+||||||||||+#~~~~~~~",
        "~~-===============oy |||BB|y  Tdbd  +D|v#~~~~~~~",
        "~~-===============oy +¨¨¨¨|         #####~~~~~~~",
        "~~-===============#  |8S8t|I       E#====~~~~~~~",
        "~~!-------========#|+||||||Ih      lo====~~~~~~~",
        "~~~~~~~~~-========#Y  Dbdy|I       E#====~~~~~~~",
        "~~~~~~~~~-========#I      |         #~~~~~~~~~~~",
        "~~~~~~~~~-========oIh   @ |   @  @  o~~~~~~~~~~~",
        "~~~~~~~~~-=======^#y   T@¤|T ¤@ ¤@  #~~~~~~~~~~~",
        "~~~~~~~~~---------##oo######o#####o##~~~~~~~~~~~",
        "~~~~~~~~~~~~~~~~~~~~~~~~~~~~~~~~~~~~~~~~~~~~~~~~",
        "~~~~~~~~~~~~~~~~~~~~~~~~~~~~~~~~~~~~~~~~~~~~~~~~"
      ],
      "palettes": [ "standard_domestic_palette", "parameterized_linoleum_color_bathroom" ],
      "terrain": { "~": "t_open_air", "=": "t_shingle_flat_roof", "!": "t_gutter_drop", "-": "t_gutter", "Q": "t_floor" },
      "place_nested": [ { "chunks": [ "NC_res_roof_chunk_3X3" ], "x": [ 4, 16 ], "y": [ 8, 12 ] } ]
    }
  },
  {
    "method": "json",
    "om_terrain": [ [ "urban_2_5", "urban_2_6" ] ],
    "type": "mapgen",
    "object": {
      "fill_ter": "t_shingle_flat_roof",
      "rows": [
        "                                                ",
        "                                                ",
        "                                                ",
        "                                                ",
        "                                                ",
        "                                                ",
        "                  -----------------------       ",
        "                  -.....................-       ",
        "                  -.....................5       ",
        "                  -.........X..........~-       ",
        "                  -.....................-       ",
        "                  -.....................-       ",
        "                  -.....................-       ",
        "                  -.....................-       ",
        "                  -.................-----       ",
        "                  -.......N.........-           ",
        "                  -.................-           ",
        "                  -............&....-           ",
        "                  -.................-           ",
        "                  -.................-           ",
        "                  5.................-           ",
        "                  -------------------           ",
        "                                                ",
        "                                                "
      ],
      "palettes": [ "roof_palette" ],
      "terrain": { ".": "t_shingle_flat_roof" },
      "place_nested": [ { "chunks": [ "NC_res_roof_solar_4X4" ], "x": 34, "y": 8 } ]
    }
  },
  {
    "method": "json",
    "om_terrain": [ [ "urban_2_1_basement", "urban_2_2_basement" ] ],
    "type": "mapgen",
    "object": {
      "fill_ter": "t_thconc_floor",
      "rows": [
        "                                                ",
        "                                                ",
        "                                                ",
        "                                                ",
        "                                                ",
        "                                                ",
        "  |||||||||||||||||    ||||||||||||||||||       ",
        "  |1..............|    |......2.........|       ",
        "  |...............||||||................|       ",
        "  |.................g.F...zz............|       ",
        "  |.....................................|       ",
        "  |.....................................|       ",
        "  |............z........................|       ",
        "  |.........z.z.........................|       ",
        "  |..................|+|Z...............|       ",
        "  |.................U|<|J...............|       ",
        "  ||||||||..........U|||W...............|       ",
        "         |..........................|||||       ",
        "         |..........................|           ",
        "         |..........................|           ",
        "         |..........................|           ",
        "         ||||||||||||||||||||||||||||           ",
        "                                                ",
        "                                                "
      ],
      "palettes": [ "basement_empty" ],
      "nested": {
        "1": { "chunks": [ [ "null", 80 ], [ "room_9x9_cellar_E", 20 ], [ "room_9x9_weed_E", 5 ], [ "room_9x9_recroom_E", 20 ] ] },
        "2": {
          "chunks": [
            [ "null", 70 ],
            [ "room_10x10_woodworker_W", 20 ],
            [ "room_10x10_guns_W", 7 ],
            [ "room_10x10_junk_W", 30 ],
            [ "room_10x10_recording_studio_W", 20 ]
          ]
        }
      }
    }
  }
]
