[
  {
    "type": "trap",
    "id": "tr_microlab_portal_elevator_physics_shift",
    "name": "microlab shifting elevator",
    "color": "magenta",
    "symbol": ".",
    "visibility": 99,
    "avoidance": 99,
    "difficulty": 99,
    "action": "map_regen",
    "map_regen": "microlab_portal_elevator_physics_shift",
    "benign": false
  },
  {
    "type": "mapgen",
    "method": "json",
    "update_mapgen_id": "microlab_portal_elevator_physics_shift",
    "object": { "place_nested": [ { "chunks": [ "microlab_portal_elevator_physics_shift" ], "x": 0, "y": 0 } ] }
  },
  {
    "type": "trap",
    "id": "tr_microlab_nether_glass_shift",
    "name": "microlab boss wall",
    "color": "magenta",
    "symbol": " ",
    "visibility": 99,
    "avoidance": 99,
    "difficulty": 99,
    "action": "map_regen",
    "map_regen": "microlab_nether_glass_shift",
    "benign": false
  },
  {
    "type": "mapgen",
    "method": "json",
    "update_mapgen_id": "microlab_nether_glass_shift",
    "object": { "place_nested": [ { "chunks": [ "microlab_nether_glass_shift" ], "x": 0, "y": 0 } ] }
  },
  {
    "type": "mapgen",
    "method": "json",
    "om_terrain": "microlab_portal_dressroom",
    "object": {
      "fill_ter": "t_strconc_floor",
      "rows": [
        "||||||            ||||||",
        "|####|yyyyyyyyyyyy|####|",
        "|##|||    S  S    |####|",
        "|##| 5            |####|",
        "|##| ||||||  ||||||####|",
        "|##| |L  L|   2  ~|####|",
        "|##| |L  L|55||  ~|####|",
        "|##| |L  L| hd(  ~|####|",
        "|##| |L  L|  d(  ~|####|",
        "|##| |L  L|55||  ~|####|",
        "|##| |L       2  ~|####|",
        "|##| ||||||22||||||####|",
        "|##| |llll|  |   ~|####|",
        "|##| |l b |22| | ~|####|",
        "|##| |l b      | ~|####|",
        "|##| |l b    | | ~|####|",
        "|##| |llll|  |   ~|####|",
        "|##| ||||||22|   ~|####|",
        "|##| |r hd|  |   ~|####|",
        "|##| 5  dd|22||||||####|",
        "|##| |||((|  ^^^^^|####|",
        "|##| 5            |####|",
        "|##|||            |####|",
        "||||||            ||||||"
      ],
      "palettes": [ "microlab" ],
      "furniture": { "L": "f_locker" },
      "items": {
        "l": [
          { "item": "lab_shoes", "chance": 100 },
          { "item": "lab_torso", "chance": 100 },
          { "item": "lab_pants", "chance": 100 },
          { "item": "underwear", "chance": 100 }
        ],
        "L": { "item": "portal_room_gear", "chance": 100 },
        "r": [ { "item": "guns_milspec", "chance": 10 }, { "item": "ammo_milspec", "chance": 70 } ]
      },
      "signs": { "S": { "signage": "Warning:\nActive anchors beyond this point." } }
    }
  },
  {
    "type": "mapgen",
    "method": "json",
    "om_terrain": [ [ "microlab_portal_elevator" ] ],
    "object": {
      "fill_ter": "t_strconc_floor",
      "rows": [
        "#####|            |#####",
        "#####|====    ====|#####",
        "#####|XXX=    =XXX|#####",
        "#####||||||22||||||#####",
        "#####|XXX|    |XXX|#####",
        "##||||===|    |===||||##",
        "##|XX=  YYPPPPYY  =XX|##",
        "##|XX=    PPPP    =XX|##",
        "##|XX=    PPPP    =XX|##",
        "##||||^ YYPPPPYY ^||||##",
        "####|N            N|####",
        "####||||  ||||  ||||####",
        "#####|--22-``-22--|#####",
        "#####|-Eee-``-eeE-|#####",
        "#####|-eee-``-eee-|#####",
        "#####|-----``-----|#####",
        "#####||||||||||||||#####",
        "########################",
        "########################",
        "########################",
        "########################",
        "########################",
        "########################",
        "########################"
      ],
      "palettes": [ "microlab" ],
      "terrain": { "`": "t_open_air" }
    }
  },
  {
    "type": "mapgen",
    "method": "json",
    "om_terrain": [ [ "microlab_portal_elevator_physics_glass" ] ],
    "object": {
      "fill_ter": "t_strconc_floor",
      "rows": [
        "#####81111111111118#####",
        "####881==S 111===18#####",
        "###888111=9999=11188####",
        "##888888888228888888####",
        "###888888811118888888###",
        "##|888888888888888888|##",
        "##|X888888888888888888##",
        "##888888888888888888888#",
        "#888888888888888888888##",
        "#8888888888888888888888#",
        "###888888888888888888###",
        "##8888888888888888888###",
        "####8888888888888888####",
        "#####88888888888888888##",
        "#####88888888888888888##",
        "###8888888888888888888##",
        "####88888888888888888###",
        "######88888888888888####",
        "#######8#8888#8888######",
        "#########88#############",
        "########################",
        "########################",
        "########################",
        "########################"
      ],
      "palettes": [ "microlab" ],
      "traps": { "9": "tr_microlab_portal_elevator_physics_shift" },
      "terrain": { "`": "t_open_air", "1": "t_nether_glass_floor", "9": "t_nether_glass_floor", "8": "t_nether_glass_wall" },
      "items": { "S": [ { "item": "physics_anomaly_description", "chance": 100 } ] }
    }
  },
  {
    "type": "mapgen",
    "method": "json",
    "nested_mapgen_id": "microlab_portal_elevator_physics_shift",
    "object": {
      "mapgensize": [ 24, 24 ],
      "rows": [
        "                        ",
        "                        ",
        "                        ",
        "           22           ",
        "           ..           ",
        "          ...||         ",
        "           ...|         ",
        "         |.....         ",
        "         ..YY.          ",
        "        ......          ",
        "       .........        ",
        "     |||..||||..|||     ",
        "     |--22-  -22--|     ",
        "     |-Eee-  -eeE-|     ",
        "     |-eee-  -eee-|     ",
        "     |-----  -----|     ",
        "     ||||||||||||||     ",
        "                        ",
        "                        ",
        "                        ",
        "                        ",
        "                        ",
        "                        ",
        "                        "
      ],
      "palettes": [ "microlab" ],
      "terrain": { ".": "t_nether_glass_floor", "2": "t_door_glass_frosted_lab_o" }
    }
  },
  {
    "type": "mapgen",
    "method": "json",
    "om_terrain": [ [ "microlab_portal_elevator_nether_glass" ] ],
    "object": {
      "fill_ter": "t_strconc_floor",
      "rows": [
        "8,,,,,,,,,,,,,,,,,,,,,,8",
        "8,,,,,,,,,,,,,,,,,,,,,,8",
        "8,,,,,,,,,,,,,,,,,,,,,,8",
        "8,,,,,,,,,  ,,,,,,,,,,,8",
        "8,,,,,,,,,,,,, ,,,,,,,,8",
        "8,,,,|===|    S,,,,,,,,8",
        "8,,,,,,,,,,,, ,   ,,,|,8",
        "8,,,,=  , P,,, ,, =,,,,8",
        "8,,,,=   ,,,PP    ,,,,,8",
        "88,,||  YYPPPPYY    ,##8",
        "888#|N             #####",
        "####||||  ||||  ||||####",
        "#####|--22-##-22--|#####",
        "#####|-Eee-##-eeE-|#####",
        "#####|-eee-##-eee-|#####",
        "#####|-----##-----|#####",
        "#####||||||||||||||#####",
        "########################",
        "########################",
        "########################",
        "########################",
        "########################",
        "########################",
        "########################"
      ],
      "palettes": [ "microlab" ],
      "terrain": { ",": "t_nether_glass_floor", "8": "t_nether_glass_wall" },
      "items": { "S": [ { "item": "physics_anomaly_epsilon", "chance": 100 } ] }
    }
  },
  {
    "type": "mapgen",
    "method": "json",
    "om_terrain": [ [ "microlab_nether_glass_entrance" ] ],
    "object": {
      "fill_ter": "t_strconc_floor",
      "rows": [
        "8,,,,,,,,,,,,,,,,,,,,,,8",
        "8,,,,,,,,,,,,,,,,,,,,,88",
        "88888,,,,,,,,,,,,,,,,88#",
        "88,,,,,,,,,,,,,,,,,,,888",
        "8,,,,,,,,,,,,,,,,,,,,,,8",
        "8888,,,,,,,,,,,,,,,,,,,8",
        "###88,,,,,,,,,,,,,,,,,,8",
        "####8,,,,,,,,,,,,,,,,,,8",
        "##888,,,,,,,,,,,,,,,,,,8",
        "888,,,,,,8,,,,,,,,,,,,,8",
        "8,,,,,,,,,,,,,,,,,,,,,88",
        "8,,,,,,,,,,,,,,,,,,,888#",
        "8,,,,,,8,,,,,,,,,,,,8###",
        "8,,,,,,,,,,,,,,,,,,,8888",
        "8,,,,,,,,,,,,,,,,,,,,,,8",
        "8,,,,,,,,,,,,,,,,8,,,,,8",
        "8,,,,,,,,,,,,,,,,,,,,888",
        "88,,,,,,,,8,,,,,,8888888",
        "888888888888888888888888",
        "888888888888,88888888888",
        "888888888888988888888888",
        "##888888,,,,,,,,,8888888",
        "###8,,,,,,,,,,,,,,,,,888",
        "#88,,,,,,,,,,,,,,,,,,,,8"
      ],
      "palettes": [ "microlab" ],
      "terrain": { ",": "t_nether_glass_floor", "8": "t_nether_glass_wall", "9": "t_carpet_red" },
      "traps": { "9": "tr_microlab_nether_glass_shift" }
    }
  },
  {
    "type": "mapgen",
    "method": "json",
    "om_terrain": [ [ "microlab_nether_glass_hallway" ] ],
    "object": {
      "fill_ter": "t_strconc_floor",
      "rows": [
        "8,,,,,,,,,,,,,,,,,,,,,,8",
        "8,,,,,,,,,,,,,,,,,,,,,,8",
        "88888,,,,,,,,,,,,,,,,,,8",
        "88,,,,,,,,,,,,,,,,,,,,,8",
        "8,,,,,,,,,,,,,,,,,,,,,,8",
        "8888,,,,,,,,,,,,,,,,,,,8",
        "###88,,,,,,,,,,,,,,,,,,8",
        "####8,,,,,,,,,,,,,,,,,,8",
        "##888,,,,,,,,,,,,,,,,,,8",
        "888,,,,,,8,,,,,,,,,,,,,8",
        "8,,,,,,,,,,,,,,,,,,,,,88",
        "8,,,,,,,,,,,,,,,,,,,888#",
        "8,,,,,,8,,,,,,,,,,,,8###",
        "8,,,,,,,,,,,,,,,,,,,8888",
        "8,,,,,,,,,,,,,,,,,,,,,,8",
        "8,,,,,,,,,,,,,,,,8,,,,,8",
        "8,,,,,,,,,,,,,,,,,,,,888",
        "888,,,,,,8,,,,,,,,,,,,,8",
        "8,,,,,,,,,,,,,,,,,,,,,88",
        "8,,,,,,,,,,,,,,,,,,,888#",
        "8,,,,,,8,,,,,,,,,,,,8###",
        "8,,,,,,,,,,,,,,,,,,,8888",
        "8,,,,,,,,,,,,,,,,,,,,888",
        "8,,,,,,,,,,,,,,,,,,,,,,8"
      ],
      "palettes": [ "microlab" ],
      "terrain": { ",": "t_nether_glass_floor", "8": "t_nether_glass_wall", "9": "t_carpet_red" }
    }
  },
  {
    "type": "mapgen",
    "method": "json",
    "om_terrain": [ [ "microlab_nether_glass_end" ] ],
    "object": {
      "fill_ter": "t_strconc_floor",
      "rows": [
        "#####888888#############",
        "####88,,,,8888888#######",
        "#8888,,,,,,,,,,,888888##",
        "88,,,,,,,,,,,,,,,,,,,888",
        "8,,,,,,,,,,,,,,,,,,,,,,8",
        "8888,,,,,,,,,,,,,,,,,,,8",
        "###88,,,,,,,,,,,,,,,,,,8",
        "####8,,,,,,,,,,,,,,,,,,8",
        "##888,,,,,,,,,,,,,,,,,,8",
        "888,,,,,,8,,,,,,,,,,,,,8",
        "8,,,,,,,,,,,,,,,,,,,,,88",
        "8,,,,,,,,,,,,,,,,,,,888#",
        "8,,,,,,8,,,,,,,,,,,,8###",
        "8,,,,,,,,,,,,,,,,,,,8888",
        "8,,,,,,,,,,,,,,,,,,,,,,8",
        "8,,,,,,,,,,,,,,,,8,,,,,8",
        "8,,,,,,,,,,,,,,,,,,,,888",
        "8,,,,,,,,,,,,,,,,,,,,,,8",
        "8,,,,,,,,,,ä,,,,,,,,,,,8",
        "88888,,,,,,,,,,,,,,,,,,8",
        "88,,,,,,,,,,,,,,,,,,,,,8",
        "8,,,,,,,,,,,,,,,,,,,,,,8",
        "8,,,,,,,,,,,,,,,,,,,,,,8",
        "8,,,,,,,,,,,,,,,,,,,,,,8"
      ],
      "palettes": [ "microlab" ],
      "terrain": { ",": "t_nether_glass_floor", "8": "t_nether_glass_wall", "9": "t_carpet_red" },
      "monster": { "ä": { "monster": "mon_anomaly_boss" } }
    }
  },
  {
    "type": "mapgen",
    "method": "json",
    "nested_mapgen_id": "microlab_nether_glass_shift",
    "object": {
      "mapgensize": [ 24, 24 ],
      "rows": [
        "                        ",
        "                        ",
        "                        ",
        "                        ",
        "                        ",
        "                        ",
        "                        ",
        "                        ",
        "                        ",
        "                        ",
        "                        ",
        "                        ",
        "                        ",
        "                        ",
        "                        ",
        "                        ",
        "                        ",
        "                        ",
        "            ,           ",
        "                        ",
        "                        ",
        "                        ",
        "                        ",
        "                        "
      ],
      "palettes": [ "microlab" ],
      "terrain": { ",": "t_nether_glass_floor" }
    }
  },
  {
    "type": "mapgen",
    "method": "json",
    "om_terrain": [ [ "microlab_nether_glass_roof" ] ],
    "object": {
      "fill_ter": "t_strconc_floor",
      "rows": [
        "888888888888888888888888",
        "888888888888888888888888",
        "888888888888888888888888",
        "888888888888888888888888",
        "888888888888888888888888",
        "888888888888888888888888",
        "888888888888888888888888",
        "888888888888888888888888",
        "888888888888888888888888",
        "888888888888888888888888",
        "888888888888888888888888",
        "888888888888888888888888",
        "888888888888888888888888",
        "888888888888888888888888",
        "888888888888888888888888",
        "888888888888888888888888",
        "888888888888888888888888",
        "888888888888888888888888",
        "888888888888888888888888",
        "888888888888888888888888",
        "888888888888888888888888",
        "888888888888888888888888",
        "888888888888888888888888",
        "888888888888888888888888"
      ],
      "palettes": [ "microlab" ],
      "terrain": { "8": "t_nether_glass_floor" }
    }
  }
]
